Year,Period,labor force participation rate,employment-population ratio,labor force,employment,unemployment,unemployment rate
2010,Jan,60.8,55.8,1344729,1234457,110272,8.2
2010,Feb,60.7,55.8,1345101,1234769,110332,8.2
2010,Mar,60.8,55.8,1346699,1236603,110096,8.2
2010,Apr,60.5,55.5,1349305,1239491,109814,8.1
2010,May,60.6,55.6,1352246,1242672,109574,8.1
2010,Jun,60.6,55.7,1354708,1245193,109515,8.1
2010,Jul,60.6,55.7,1356281,1246536,109745,8.1
2010,Aug,60.6,55.7,1357229,1246897,110332,8.1
2010,Sep,60.6,55.6,1357956,1246675,111281,8.2
2010,Oct,60.6,55.6,1358740,1246341,112399,8.3
2010,Nov,60.6,55.5,1359844,1246324,113520,8.3
2010,Dec,60.6,55.5,1361151,1246683,114468,8.4
2011,Jan,60.6,55.5,1362117,1246936,115181,8.5
2011,Feb,60.6,55.5,1362339,1246677,115662,8.5
2011,Mar,60.5,55.4,1361797,1245986,115811,8.5
2011,Apr,60.5,55.3,1360729,1245118,115611,8.5
2011,May,60.4,55.3,1359781,1244596,115185,8.5
2011,Jun,60.3,55.2,1359520,1244978,114542,8.4
2011,Jul,60.3,55.3,1360317,1246599,113718,8.4
2011,Aug,60.4,55.4,1361993,1249276,112717,8.3
2011,Sep,60.4,55.5,1363951,1252523,111428,8.2
2011,Oct,60.5,55.6,1365660,1255728,109932,8.0
2011,Nov,60.5,55.7,1366313,1258015,108298,7.9
2011,Dec,60.4,55.7,1365422,1258774,106648,7.8
2012,Jan,60.3,55.6,1363322,1258194,105128,7.7
2012,Feb,60.1,55.5,1360430,1256572,103858,7.6
2012,Mar,60.0,55.4,1357024,1254064,102960,7.6
2012,Apr,59.8,55.3,1353406,1250988,102418,7.6
2012,May,59.6,55.1,1349774,1247651,102123,7.6
2012,Jun,59.4,54.9,1345970,1244049,101921,7.6
2012,Jul,59.2,54.7,1341588,1239998,101590,7.6
2012,Aug,58.9,54.5,1336800,1235720,101080,7.6
2012,Sep,58.7,54.3,1332413,1231885,100528,7.5
2012,Oct,58.5,54.1,1328909,1228964,99945,7.5
2012,Nov,58.4,54.0,1326628,1227266,99362,7.5
2012,Dec,58.4,54.0,1325703,1226880,98823,7.5
2013,Jan,58.3,54.0,1325721,1227306,98415,7.4
2013,Feb,58.4,54.0,1326140,1227981,98159,7.4
2013,Mar,58.4,54.0,1326434,1228455,97979,7.4
2013,Apr,58.3,54.0,1326202,1228419,97783,7.4
2013,May,58.3,54.0,1325281,1227772,97509,7.4
2013,Jun,58.2,53.9,1324000,1226874,97126,7.3
2013,Jul,58.1,53.9,1322766,1226174,96592,7.3
2013,Aug,58.0,53.8,1321408,1225720,95688,7.2
2013,Sep,57.9,53.8,1319612,1225301,94311,7.1
2013,Oct,57.8,53.7,1317651,1224973,92678,7.0
2013,Nov,57.7,53.7,1315812,1224887,90925,6.9
2013,Dec,57.6,53.7,1314233,1225176,89057,6.8
2014,Jan,57.6,53.7,1313361,1226351,87010,6.6
2014,Feb,57.5,53.8,1312912,1227953,84959,6.5
2014,Mar,57.5,53.9,1312795,1229772,83023,6.3
2014,Apr,57.5,53.9,1312909,1231554,81355,6.2
2014,May,57.5,54.0,1313181,1233243,79938,6.1
2014,Jun,57.5,54.0,1313710,1234973,78737,6.0
2014,Jul,57.5,54.1,1314665,1236927,77738,5.9
2014,Aug,57.5,54.2,1316300,1239340,76960,5.8
2014,Sep,57.6,54.3,1318569,1242232,76337,5.8
2014,Oct,57.7,54.4,1321016,1245304,75712,5.7
2014,Nov,57.8,54.5,1323148,1248056,75092,5.7
2014,Dec,57.8,54.5,1324880,1250267,74613,5.6
2015,Jan,57.8,54.6,1326036,1252085,73951,5.6
2015,Feb,57.9,54.7,1327114,1253507,73607,5.5
2015,Mar,57.9,54.7,1328132,1255129,73003,5.5
2015,Apr,57.9,54.8,1329207,1257263,71944,5.4
2015,May,57.9,54.9,1330320,1259919,70401,5.3
2015,Jun,58.0,55.0,1331306,1262825,68481,5.1
2015,Jul,58.0,55.1,1332142,1265765,66377,5.0
2015,Aug,58.0,55.2,1332836,1268549,64287,4.8
2015,Sep,58.0,55.3,1333420,1271086,62334,4.7
2015,Oct,58.0,55.3,1334177,1273561,60616,4.5
2015,Nov,58.0,55.4,1335284,1276163,59121,4.4
2015,Dec,58.0,55.5,1336483,1278705,57778,4.3
2016,Jan,58.0,55.6,1337486,1280917,56569,4.2
2016,Feb,58.0,55.6,1338202,1282661,55541,4.2
2016,Mar,58.0,55.7,1338608,1283913,54695,4.1
2016,Apr,58.0,55.7,1338900,1284824,54076,4.0
2016,May,58.0,55.7,1339336,1285666,53670,4.0
2016,Jun,58.0,55.7,1339929,1286579,53350,4.0
2016,Jul,58.0,55.7,1340483,1287491,52992,4.0
2016,Aug,58.0,55.7,1340822,1288257,52565,3.9
2016,Sep,58.0,55.7,1340911,1288824,52087,3.9
2016,Oct,57.9,55.7,1340679,1289185,51494,3.8
2016,Nov,57.9,55.7,1340333,1289558,50775,3.8
2016,Dec,57.9,55.7,1340253,1290214,50039,3.7
2017,Jan,57.9,55.7,1340760,1291336,49424,3.7
2017,Feb,57.9,55.8,1341916,1292907,49009,3.7
2017,Mar,57.9,55.8,1343493,1294611,48882,3.6
2017,Apr,58.0,55.9,1345229,1296194,49035,3.6
2017,May,58.0,55.9,1346838,1297486,49352,3.7
2017,Jun,58.1,55.9,1348160,1298417,49743,3.7
2017,Jul,58.1,55.9,1349144,1299024,50120,3.7
2017,Aug,58.1,55.9,1349708,1299345,50363,3.7
2017,Sep,58.1,55.9,1349858,1299427,50431,3.7
2017,Oct,58.0,55.9,1349769,1299370,50399,3.7
2017,Nov,58.0,55.8,1349591,1299197,50394,3.7
2017,Dec,58.0,55.8,1349478,1299051,50427,3.7
2018,Jan,58.0,55.8,1349555,1299054,50501,3.7
2018,Feb,58.0,55.8,1349868,1299305,50563,3.7
2018,Mar,58.0,55.8,1350386,1299917,50469,3.7
2018,Apr,58.0,55.8,1350866,1300745,50121,3.7
2018,May,58.0,55.8,1351212,1301603,49609,3.7
2018,Jun,58.0,55.9,1351596,1302534,49062,3.6
2018,Jul,58.0,55.9,1352169,1303583,48586,3.6
2018,Aug,58.0,55.9,1353228,1304892,48336,3.6
2018,Sep,58.0,55.9,1354940,1306573,48367,3.6
2018,Oct,58.1,56.0,1357108,1308521,48587,3.6
2018,Nov,58.2,56.1,1359350,1310531,48819,3.6
2018,Dec,58.2,56.1,1361225,1312311,48914,3.6
2019,Jan,58.3,56.2,1362313,1313527,48786,3.6
2019,Feb,58.2,56.2,1362467,1313963,48504,3.6
2019,Mar,58.2,56.1,1361942,1313673,48269,3.5
2019,Apr,58.2,56.1,1361142,1312967,48175,3.5
2019,May,58.1,56.0,1360506,1312287,48219,3.5
2019,Jun,58.1,56.0,1360371,1312004,48367,3.6
2019,Jul,58.1,56.0,1361041,1312512,48529,3.6
2019,Aug,58.1,56.0,1362055,1313485,48570,3.6
2019,Sep,58.1,56.1,1363257,1314807,48450,3.6
2019,Oct,58.1,56.1,1364178,1315900,48278,3.5
2019,Nov,58.1,56.1,1364331,1316141,48190,3.5
2019,Dec,58.1,56.0,1364255,1316069,48186,3.5
2020,Jan,58.2,56.1,1366308,1318240,48068,3.5
2020,Feb,58.2,56.2,1367709,1319907,47802,3.5
2020,Mar,59.0,56.0,1386469,1316741,69728,5.0
2020,Apr,55.7,49.7,1309681,1168783,140898,10.8
2020,May,57.2,51.7,1345509,1216249,129260,9.6
2020,Jun,55.9,51.3,1314162,1207757,106405,8.1
2020,Jul,55.5,51.5,1305613,1212637,92976,7.1
2020,Aug,57.1(P),52.8(P),1343832(P),1244400(P),99432(P),7.4(P)
