Year,Period,labor force participation rate,employment-population ratio,labor force,employment,unemployment,unemployment rate
2010,Jan,70.5,66.1,358889,336293,22596,6.3
2010,Feb,70.6,66.1,359206,336679,22527,6.3
2010,Mar,70.6,66.2,359488,337067,22421,6.2
2010,Apr,71.0,66.6,359650,337367,22283,6.2
2010,May,71.0,66.6,359676,337561,22115,6.1
2010,Jun,71.0,66.6,359582,337664,21918,6.1
2010,Jul,70.9,66.6,359413,337695,21718,6.0
2010,Aug,70.8,66.6,359276,337710,21566,6.0
2010,Sep,70.8,66.5,359252,337779,21473,6.0
2010,Oct,70.7,66.5,359347,337959,21388,6.0
2010,Nov,70.7,66.5,359482,338211,21271,5.9
2010,Dec,70.7,66.5,359583,338459,21124,5.9
2011,Jan,70.7,66.5,359600,338684,20916,5.8
2011,Feb,70.6,66.6,359462,338839,20623,5.7
2011,Mar,70.5,66.5,359114,338856,20258,5.6
2011,Apr,70.4,66.5,358632,338757,19875,5.5
2011,May,70.2,66.4,358156,338583,19573,5.5
2011,Jun,70.1,66.3,357806,338394,19412,5.4
2011,Jul,70.0,66.3,357628,338273,19355,5.4
2011,Aug,70.0,66.2,357560,338229,19331,5.4
2011,Sep,70.0,66.2,357501,338220,19281,5.4
2011,Oct,70.0,66.2,357373,338215,19158,5.4
2011,Nov,69.9,66.2,357092,338179,18913,5.3
2011,Dec,69.8,66.2,356626,338085,18541,5.2
2012,Jan,69.7,66.1,356060,337924,18136,5.1
2012,Feb,69.6,66.1,355564,337735,17829,5.0
2012,Mar,69.5,66.1,355263,337573,17690,5.0
2012,Apr,69.5,66.0,355193,337472,17721,5.0
2012,May,69.5,66.0,355266,337429,17837,5.0
2012,Jun,69.5,66.0,355347,337423,17924,5.0
2012,Jul,69.5,66.0,355337,337423,17914,5.0
2012,Aug,69.5,66.0,355150,337388,17762,5.0
2012,Sep,69.4,65.9,354731,337260,17471,4.9
2012,Oct,69.2,65.9,354098,337000,17098,4.8
2012,Nov,69.0,65.8,353371,336655,16716,4.7
2012,Dec,68.9,65.7,352681,336295,16386,4.6
2013,Jan,68.8,65.6,352098,335962,16136,4.6
2013,Feb,68.7,65.6,351601,335640,15961,4.5
2013,Mar,68.6,65.5,351208,335359,15849,4.5
2013,Apr,68.5,65.4,350902,335131,15771,4.5
2013,May,68.5,65.4,350653,334953,15700,4.5
2013,Jun,68.4,65.3,350450,334828,15622,4.5
2013,Jul,68.3,65.3,350269,334747,15522,4.4
2013,Aug,68.3,65.3,350093,334713,15380,4.4
2013,Sep,68.2,65.3,349922,334732,15190,4.3
2013,Oct,68.2,65.3,349740,334774,14966,4.3
2013,Nov,68.1,65.3,349505,334766,14739,4.2
2013,Dec,68.1,65.3,349195,334664,14531,4.2
2014,Jan,68.0,65.2,348789,334392,14397,4.1
2014,Feb,67.9,65.1,348373,334148,14225,4.1
2014,Mar,67.9,65.1,347991,333927,14064,4.0
2014,Apr,67.8,65.1,347648,333732,13916,4.0
2014,May,67.7,65.0,347340,333562,13778,4.0
2014,Jun,67.6,65.0,347058,333408,13650,3.9
2014,Jul,67.6,64.9,346782,333246,13536,3.9
2014,Aug,67.5,64.9,346532,333089,13443,3.9
2014,Sep,67.5,64.8,346335,332962,13373,3.9
2014,Oct,67.4,64.8,346193,332882,13311,3.8
2014,Nov,67.4,64.8,346103,332866,13237,3.8
2014,Dec,67.3,64.8,346056,332922,13134,3.8
2015,Jan,67.4,64.8,346140,333128,13012,3.8
2015,Feb,67.3,64.8,346065,333208,12857,3.7
2015,Mar,67.3,64.8,345916,333220,12696,3.7
2015,Apr,67.2,64.8,345658,333115,12543,3.6
2015,May,67.2,64.7,345293,332883,12410,3.6
2015,Jun,67.0,64.7,344857,332558,12299,3.6
2015,Jul,66.9,64.6,344407,332209,12198,3.5
2015,Aug,66.9,64.5,343988,331896,12092,3.5
2015,Sep,66.8,64.5,343654,331684,11970,3.5
2015,Oct,66.7,64.4,343472,331636,11836,3.4
2015,Nov,66.7,64.5,343457,331759,11698,3.4
2015,Dec,66.8,64.5,343581,332010,11571,3.4
2016,Jan,66.8,64.6,343783,332316,11467,3.3
2016,Feb,66.9,64.6,344012,332618,11394,3.3
2016,Mar,66.9,64.7,344235,332889,11346,3.3
2016,Apr,66.9,64.7,344432,333124,11308,3.3
2016,May,67.0,64.8,344602,333340,11262,3.3
2016,Jun,67.0,64.8,344754,333559,11195,3.2
2016,Jul,67.0,64.9,344897,333788,11109,3.2
2016,Aug,67.0,64.9,345054,334040,11014,3.2
2016,Sep,67.0,64.9,345211,334287,10924,3.2
2016,Oct,67.0,64.9,345320,334465,10855,3.1
2016,Nov,67.0,64.9,345362,334551,10811,3.1
2016,Dec,67.0,64.9,345332,334549,10783,3.1
2017,Jan,67.0,64.9,345256,334506,10750,3.1
2017,Feb,67.0,64.9,345177,334487,10690,3.1
2017,Mar,66.9,64.9,345141,334542,10599,3.1
2017,Apr,66.9,64.9,345195,334713,10482,3.0
2017,May,66.9,64.9,345346,334993,10353,3.0
2017,Jun,67.0,65.0,345563,335338,10225,3.0
2017,Jul,67.0,65.0,345823,335717,10106,2.9
2017,Aug,67.0,65.1,346055,336064,9991,2.9
2017,Sep,67.0,65.1,346211,336340,9871,2.9
2017,Oct,67.0,65.2,346301,336560,9741,2.8
2017,Nov,67.0,65.2,346324,336722,9602,2.8
2017,Dec,67.0,65.2,346302,336833,9469,2.7
2018,Jan,67.0,65.2,346242,336887,9355,2.7
2018,Feb,67.0,65.2,346156,336893,9263,2.7
2018,Mar,67.0,65.2,346063,336880,9183,2.7
2018,Apr,66.9,65.2,345950,336849,9101,2.6
2018,May,66.9,65.2,345804,336798,9006,2.6
2018,Jun,66.8,65.1,345614,336722,8892,2.6
2018,Jul,66.8,65.1,345363,336600,8763,2.5
2018,Aug,66.7,65.0,345074,336441,8633,2.5
2018,Sep,66.6,65.0,344789,336276,8513,2.5
2018,Oct,66.6,64.9,344533,336125,8408,2.4
2018,Nov,66.5,64.9,344339,336025,8314,2.4
2018,Dec,66.5,64.9,344212,335986,8226,2.4
2019,Jan,66.5,64.9,344128,335981,8147,2.4
2019,Feb,66.4,64.9,344021,335938,8083,2.3
2019,Mar,66.4,64.8,343817,335772,8045,2.3
2019,Apr,66.3,64.8,343481,335445,8036,2.3
2019,May,66.2,64.7,343025,334970,8055,2.3
2019,Jun,66.1,64.5,342493,334399,8094,2.4
2019,Jul,66.0,64.4,341929,333781,8148,2.4
2019,Aug,65.8,64.3,341361,333162,8199,2.4
2019,Sep,65.8,64.2,340947,332709,8238,2.4
2019,Oct,65.7,64.1,340685,332422,8263,2.4
2019,Nov,65.7,64.1,340681,332418,8263,2.4
2019,Dec,65.7,64.1,340749,332491,8258,2.4
2020,Jan,65.6,64.0,340538,332233,8305,2.4
2020,Feb,65.6,64.0,340142,331947,8195,2.4
2020,Mar,65.7,63.6,340607,330084,10523,3.1
2020,Apr,67.6,56.5,350944,293039,57905,16.5
2020,May,66.3,57.8,343838,299688,44150,12.8
2020,Jun,65.8,59.6,341591,309139,32452,9.5
2020,Jul,65.4,59.9,339162,310976,28186,8.3
2020,Aug,62.5(P),59.5(P),324350(P),308908(P),15442(P),4.8(P)
