Year,Period,labor force participation rate,employment-population ratio,labor force,employment,unemployment,unemployment rate
2010,Jan,71.5,66.0,2931636,2705380,226256,7.7
2010,Feb,71.5,66.0,2934157,2709231,224926,7.7
2010,Mar,71.5,66.1,2936270,2713397,222873,7.6
2010,Apr,71.5,66.1,2937670,2717445,220225,7.5
2010,May,71.5,66.2,2938435,2721066,217369,7.4
2010,Jun,71.4,66.2,2938805,2723778,215027,7.3
2010,Jul,71.4,66.2,2939250,2725306,213944,7.3
2010,Aug,71.4,66.2,2940138,2725971,214167,7.3
2010,Sep,71.3,66.1,2941269,2726480,214789,7.3
2010,Oct,71.3,66.1,2942146,2727688,214458,7.3
2010,Nov,71.3,66.1,2942245,2729932,212313,7.2
2010,Dec,71.2,66.1,2941809,2733191,208618,7.1
2011,Jan,71.1,66.2,2941435,2737393,204042,6.9
2011,Feb,71.1,66.3,2941838,2741696,200142,6.8
2011,Mar,71.1,66.3,2943124,2745212,197912,6.7
2011,Apr,71.1,66.3,2945087,2747838,197249,6.7
2011,May,71.1,66.3,2947426,2749971,197455,6.7
2011,Jun,71.1,66.4,2949387,2752143,197244,6.7
2011,Jul,71.1,66.4,2950563,2755094,195469,6.6
2011,Aug,71.0,66.4,2950646,2758898,191748,6.5
2011,Sep,70.9,66.5,2949489,2762924,186565,6.3
2011,Oct,70.8,66.5,2947613,2766525,181088,6.1
2011,Nov,70.8,66.5,2945429,2769210,176219,6.0
2011,Dec,70.7,66.5,2943191,2770778,172413,5.9
2012,Jan,70.6,66.5,2941312,2771438,169874,5.8
2012,Feb,70.5,66.5,2940126,2771941,168185,5.7
2012,Mar,70.4,66.4,2939631,2772639,166992,5.7
2012,Apr,70.4,66.4,2939742,2773408,166334,5.7
2012,May,70.4,66.4,2940579,2774614,165965,5.6
2012,Jun,70.4,66.4,2942474,2776729,165745,5.6
2012,Jul,70.4,66.4,2945136,2779732,165404,5.6
2012,Aug,70.4,66.5,2948475,2783485,164990,5.6
2012,Sep,70.4,66.5,2952420,2787876,164544,5.6
2012,Oct,70.5,66.6,2955833,2792315,163518,5.5
2012,Nov,70.5,66.6,2958006,2796171,161835,5.5
2012,Dec,70.4,66.6,2958803,2799077,159726,5.4
2013,Jan,70.4,66.6,2958448,2801058,157390,5.3
2013,Feb,70.3,66.6,2957536,2802512,155024,5.2
2013,Mar,70.3,66.6,2956696,2803957,152739,5.2
2013,Apr,70.2,66.7,2956563,2805906,150657,5.1
2013,May,70.2,66.7,2957110,2808169,148941,5.0
2013,Jun,70.2,66.7,2957938,2810445,147493,5.0
2013,Jul,70.1,66.7,2958811,2812690,146121,4.9
2013,Aug,70.1,66.7,2959293,2814962,144331,4.9
2013,Sep,70.0,66.7,2959346,2817257,142089,4.8
2013,Oct,70.0,66.7,2959868,2819676,140192,4.7
2013,Nov,70.0,66.7,2961337,2822308,139029,4.7
2013,Dec,70.0,66.7,2963292,2825014,138278,4.7
2014,Jan,70.0,66.7,2964752,2827317,137435,4.6
2014,Feb,70.0,66.8,2966238,2830253,135985,4.6
2014,Mar,70.0,66.8,2967430,2833677,133753,4.5
2014,Apr,69.9,66.9,2968228,2837486,130742,4.4
2014,May,69.9,66.9,2968773,2841721,127052,4.3
2014,Jun,69.9,67.0,2969723,2846504,123219,4.1
2014,Jul,69.9,67.1,2971460,2851481,119979,4.0
2014,Aug,69.9,67.1,2974054,2856280,117774,4.0
2014,Sep,69.9,67.2,2977012,2860581,116431,3.9
2014,Oct,69.9,67.2,2979545,2864148,115397,3.9
2014,Nov,69.9,67.2,2981152,2867002,114150,3.8
2014,Dec,69.9,67.3,2982491,2869598,112893,3.8
2015,Jan,70.0,67.3,2986322,2874200,112122,3.8
2015,Feb,70.0,67.4,2988962,2877096,111866,3.7
2015,Mar,70.1,67.4,2992271,2880260,112011,3.7
2015,Apr,70.1,67.5,2995715,2883633,112082,3.7
2015,May,70.1,67.5,2998720,2886844,111876,3.7
2015,Jun,70.1,67.5,3000794,2889448,111346,3.7
2015,Jul,70.1,67.5,3001995,2891466,110529,3.7
2015,Aug,70.1,67.5,3002926,2893249,109677,3.7
2015,Sep,70.1,67.5,3004387,2895400,108987,3.6
2015,Oct,70.1,67.5,3007353,2898465,108888,3.6
2015,Nov,70.1,67.6,3012066,2902407,109659,3.6
2015,Dec,70.2,67.6,3017428,2906659,110769,3.7
2016,Jan,70.3,67.7,3022094,2910450,111644,3.7
2016,Feb,70.3,67.7,3025460,2913180,112280,3.7
2016,Mar,70.3,67.7,3027550,2914689,112861,3.7
2016,Apr,70.3,67.7,3029031,2915312,113719,3.8
2016,May,70.3,67.6,3030768,2915661,115107,3.8
2016,Jun,70.3,67.6,3033097,2916186,116911,3.9
2016,Jul,70.3,67.6,3036017,2917152,118865,3.9
2016,Aug,70.3,67.5,3039275,2918624,120651,4.0
2016,Sep,70.3,67.5,3042451,2920504,121947,4.0
2016,Oct,70.3,67.5,3044793,2922732,122061,4.0
2016,Nov,70.3,67.5,3046156,2925607,120549,4.0
2016,Dec,70.3,67.6,3047127,2929230,117897,3.9
2017,Jan,70.3,67.6,3048278,2933511,114767,3.8
2017,Feb,70.3,67.7,3049745,2938220,111525,3.7
2017,Mar,70.3,67.8,3051441,2942677,108764,3.6
2017,Apr,70.3,67.8,3053567,2946664,106903,3.5
2017,May,70.3,67.8,3055914,2950324,105590,3.5
2017,Jun,70.3,67.9,3058239,2953742,104497,3.4
2017,Jul,70.3,67.9,3060454,2956931,103523,3.4
2017,Aug,70.2,67.9,3061889,2959715,102174,3.3
2017,Sep,70.2,67.9,3062333,2962056,100277,3.3
2017,Oct,70.1,67.9,3062047,2964049,97998,3.2
2017,Nov,70.1,67.9,3061481,2965577,95904,3.1
2017,Dec,70.0,67.9,3061162,2966934,94228,3.1
2018,Jan,70.0,67.9,3061622,2968564,93058,3.0
2018,Feb,70.0,67.9,3063130,2970767,92363,3.0
2018,Mar,70.0,67.9,3065197,2973525,91672,3.0
2018,Apr,70.0,67.9,3066759,2976186,90573,3.0
2018,May,70.0,67.9,3067566,2978174,89392,2.9
2018,Jun,69.9,67.9,3067978,2979644,88334,2.9
2018,Jul,69.9,67.9,3068467,2981142,87325,2.8
2018,Aug,69.9,67.9,3070293,2983142,87151,2.8
2018,Sep,69.9,67.9,3073942,2985670,88272,2.9
2018,Oct,70.0,67.9,3079042,2988502,90540,2.9
2018,Nov,70.0,67.9,3084727,2991361,93366,3.0
2018,Dec,70.1,67.9,3089750,2993761,95989,3.1
2019,Jan,70.2,67.9,3093308,2995382,97926,3.2
2019,Feb,70.2,67.9,3095337,2996333,99004,3.2
2019,Mar,70.2,67.9,3096730,2997265,99465,3.2
2019,Apr,70.2,67.9,3098456,2999023,99433,3.2
2019,May,70.2,67.9,3101106,3002006,99100,3.2
2019,Jun,70.2,68.0,3105019,3006047,98972,3.2
2019,Jul,70.3,68.0,3110509,3011020,99489,3.2
2019,Aug,70.4,68.1,3115785,3015505,100280,3.2
2019,Sep,70.4,68.1,3120459,3019383,101076,3.2
2019,Oct,70.4,68.1,3123561,3021790,101771,3.3
2019,Nov,70.4,68.1,3123569,3021641,101928,3.3
2019,Dec,70.3,68.0,3123024,3021131,101893,3.3
2020,Jan,70.3,68.1,3122744,3023966,98778,3.2
2020,Feb,70.2,68.1,3121329,3025204,96125,3.1
2020,Mar,69.6,67.6,3094328,3005502,88826,2.9
2020,Apr,68.9,62.9,3066464,2799493,266971,8.7
2020,May,68.9,62.1,3069944,2766978,302966,9.9
2020,Jun,69.9,63.9,3114109,2846131,267978,8.6
2020,Jul,69.4,64.1,3093304,2856757,236547,7.6
2020,Aug,69.8(P),64.6(P),3113122(P),2881523(P),231599(P),7.4(P)
